111111111
100000001
100000001
100000C01
1E000P001
111111111