111111111
10000E001
100000C01
100000001
10000P001
111111111